########
#      ######
#  $     .  #
# $ $       # 
# + .  #   ####
#      #     $#
######## $    #
       ########