########
#      ######
#  $     .  #
# $ $   .  $# 
# + .  #  .####
#.    .#     $#
######## $    #
       ########